1	1	1	1	1	2	3	4	5	6	7	1	1	8	9	1	
1	8	9	1	1	10	11	12	13	14	15	1	1	16	17	1	
1	16	18	19	20	21	22	23	24	25	26	27	28	1	1	1	
1	1	29	30	31	32	33	34	35	36	37	38	39	40	1	1	
41	1	42	43	44	45	46	47	48	49	50	51	52	53	54	55	
1	1	1	1	1	1	1	1	1	56	57	1	1	1	58	59	
54	55	1	1	1	1	1	1	1	1	1	1	1	54	60	61	
58	62	63	1	1	1	1	1	1	1	1	1	1	58	64	61	
65	66	67	1	1	1	1	1	1	1	1	1	1	65	75	61	
65	76	62	63	1	1	1	1	1	1	1	1	54	60	75	61	
78	79	80	81	82	83	84	85	86	87	88	89	90	91	92	93	
94	95	94	95	94	95	94	95	94	95	94	95	94	95	94	95	
96	97	96	97	96	97	96	97	96	97	96	97	96	97	96	97