1	1	1	1	1	1	1	1	1	1	1	1	1	1	1	1	
1	1	1	1	3	4	5	4	6	4	7	4	5	1	1	1	
1	1	1	1	8	1	1	1	8	1	1	1	8	1	1	1	
1	4	9	4	10	1	1	1	11	4	12	4	13	1	1	1	
1	1	1	1	14	1	1	1	8	1	1	1	1	1	1	1	
1	1	1	1	11	4	15	4	16	1	1	17	18	19	1	1	
1	1	1	1	8	1	1	1	1	17	18	20	21	22	1	1	
1	1	1	23	11	23	13	4	5	24	5	4	25	26	1	1	
1	1	23	23	8	23	23	1	8	26	1	1	1	26	1	1	
1	1	23	23	27	4	5	4	28	29	18	18	18	20	1	1	
1	1	1	1	1	1	1	1	1	1	1	1	1	1	1	1